######################
#1    #       #      #
# #  2###   #### #####
# #                  #
#    p #  p  #  ### ##
##########           #
# #     #   ####    ##
#             p      #
# #######   #######  #
#    #  #   #p       #
# ####  #   ### ###  #
#    #    #          #
######################