######################
#1    #       #    Bb#
# #   ###   #### #####
# #                  #
#    p #  p  #  ### ##
##########           #
# #     #   ####    ##
#             p      #
# #######   #######  #
#    #  #   #p       #
# ####  #   ### ###  #
#    #    #         2#
######################